9,5,5,5,1,5,5,1,3,11
10,9,1,3,12,1,3,14,12,6
10,14,14,10,13,2,8,5,7,11
8,5,3,8,1,4,4,7,11,10
10,13,6,10,12,5,5,5,4,2
8,5,7,12,5,1,5,1,3,10
8,5,5,7,11,14,13,2,14,10
10,13,5,3,10,9,1,6,13,2
8,5,5,4,4,2,12,1,7,10
12,5,5,7,13,6,13,4,7,14